XXXXXXXXXXXXXXXXXXXXXXXXXXXXXXXXXXXXXXXXXX
XX                XX  UU                XX
XX                XX  XX                XX
XX                XX  XX                XX
XX                XX  XX                XX
XX                XX  XX                XX
XX                XX  XX                XX
XX            XXXXXX  XXXXXX            XX
XX            XX          XX            XX
XXUUXXXXXXXXXXXX          XXXXXXXXXXXXXXXX
XX                                      XX
XXXXXXXXXXXXXXXX          XXXXXXXXXXXXXXXX
XX            XX          XX            XX
XX            XXXXXX  XXXXXX            XX
XX                XX  XX                XX
XX                XX  XX                XX
XX                UU  UU                XX
XX                XX  XX                XX
XX                XX  XX                XX
XX                XX  XX                XX
XXXXXXXXXXXXXXXXXXXXXXXXXXXXXXXXXXXXXXXXXX