XXXXXXXXXXXXXXXXXXXXXXXXXXXXXXXXXXXXXXXXXX
XX                XX                    XX
XX                XX  XX                XX
XX                XX  XX                XX
XX                XX  XX                XX
XX                XX  XX                XX
XX                XX  XX                XX
XX            XXXXXX  XXXXXX            XX
XX            XX          XX            XX
XX  XXXXXXXXXXXX          XXXXXXXXXXXXXXXX
XX                                      XX
XXXXXXXXXXXXXXXX          XXXXXXXXXXXXXXXX
XX            XX          XX            XX
XX            XXXXXX  XXXXXX            XX
XX                XX  XX                XX
XX                XX  XX                XX
XX                                      XX
XX                XX  XX                XX
XX                XX  XX                XX
XX                XX  XX                XX
XXXXXXXXXXXXXXXXXXXXXXXXXXXXXXXXXXXXXXXXXX